          ###############
        ##              #
                   #    #
    ##      #      ###  #
   #        #           #
  #         #           #
 #          #       #   #
#           #  ####     #
# ###       #           #
#     ####  #           #
#           #    #      #
#     #          #      #
#     #    ###   #      #
#     #          #      #
#     #     #           #
#           #  ###       
#           #      ###   
#     ####  #            
#   #       #          # 
#           #         #  
#           #        #   
#  ###      #      ##    
#    #           ##      
#              ##        
###########  ##          
