  #######################
                        #
#           ####        #
#     ####              #
#                        
#           #            
#     ####              #
#                       #
#        #######        #
#                       #
#                       #
#                       #
#############  ###  #####
#                       #
#      #######          #
#                       #
#           #####       #
#                       #
#                       #
#       #####           #
#                       #
#                       #
#                       #
#                        
#######################  
