   ######################
#                   #   #
#  #####     #      #   #
#            #      #   #
# ######            # # #
# #                      
# ########     ######## #
#                       #
# ####    ### #      #  #
# #  #      #        #  #
# #  #    # ###      #  #
#                    #  #
########  ###############
#                   #   #
#  #####     #      #   #
#            #      #   #
# ######            # # #
# #                     #
# ########     ######## #
#                        
# ####    ### #      #   
# #  #      #        #  #
# #  #    # ###      #  #
#                    #  #
##########  ###########  
